############################
#            ##            #
# #### ##### ## ##### #### #
# #### ##### ## ##### #### #
# #### ##### ## ##### #### #
#                          #
# #### ## ######## ## #### #
#      ##    ##    ##      #
###### ##### ## ##### ######
###### ##### ## ##### ######
###### ##          ## ######
###### ## ###--### ## ######
!         ##BYIC##         !
!         ########         !
###### ##          ## ######
###### ## ######## ## ######
###### ## ######## ## ######
#            ##            #
# #### ##### ## ##### #### #
#   ##       P        ##   #
### ## ## ######## ## ## ###
#      ##    ##    ##      #
# ########## ## ########## #
#                          #
############################